6
. x x x x x x x x x x x x . .
. x C . x # x C . x C . x . .
. x F . - . x x . x F . x . .
. x . . F x x . . x . . x . .
. x . F F . . F . . . F x . .
. x . . F * . . . x x x x . .
. x F . F . . . . . . . x . .
. x . . F . . . . x x . x . .
. x . F F F F F F x . . x . .
. x . x . . . F C . . F x . .
. x . x . x . F F F . F x . .
. x . . . x . . . . . . x . .
. x C x . x . F F F F C x . .
. x x x x x x x x x x x x . .
. . . . . . . . . . . . . . .